##########
#========#
#========#
#========#
#========#
#========#
#========#
#========#
#========#
##########
-Z-
AAAAAAAAAA
C        B
C        B
C        B
C        B
C        B
C        B
C        B
C        B
rrrrrrrrrr
-Z-
AAAAAAAAAA
C        B
C        B
C        B
C        B
C        B
C        B
C        B
C        B
rrrrrrrrrr
