{"origin": [1,1,1],
"pointlights": [[1,1,5], [8,1,5]]}
-LEVEL-
MMMMMMMMMM
MMMMMMMMMM
MMMMMMMMMM
MMMMMMMMMM
MMMMMMMMMM
MMMMMMMMMM
MMMMMMMMMM
MMMMMMMMMM
MMMMMMMMMM
MMMMMMMMMM
MMMMMMMMMM
MMMMMMMMMM
MMMMMMMMMM
-Z-
MMMMMMMMMM
MMMMMMMMMM
MMMMMMMMMM
MLLLLLLLLM
MLLLLLLLLM
MLLLLLLLLM
MLLLLLLLLM
MLLLLLLLLM
MLLLLLLLLM
MMMMMMMMMM
MMMMMMMMMM
MMMMMMMMMM
MMMMMMMMMM
-Z-
MMMMMMMMMM
MMMMMMMMMM
MMMMMMMMMM
M        M
M        M
M        M
M        M
M        M
M        M
MMMMMMMMMM
MMMMMMMMMM
MMMMMMMMMM
MMMMMMMMMM
-Z-
MMMMMMMMMM
MMMMMMMMMM
MMMMMMMMMM
#        M
M        M
M        M
M        M
M        M
M        M
MMMMMMMMMM
MMMMMMMMMM
MMMMMMMMMM
MMMMMMMMMM
-Z-
MMMMMMMMMM
M        M
M        M
M        M
M        M
M        M
M        M
M        M
M        M
M        M
M        M
M        M
MMMMMMMMMM
-Z-
MMMMMMMMMM
M        M
M        M
M        M
M        M
M        M
M        M
M        M
M        M
M        M
M        M
MX       M
M#MMMMMMMM
-Z-
MMMMMMMMMM
MMMMMMMMMM
MMMMMMMMMM
MMMMMMMMMM
MMMMMMMMMM
MMMMMMMMMM
MMMMMMMMMM
MMMMMMMMMM
MMMMMMMMMM
MMMMMMMMMM
MMMMMMMMMM
MMMMMMMMMM
MMMMMMMMMM
-Z-
