{"origin": [6,6,3]}
-LEVEL-
##########
#========#
#========#
#========#
#========#
#========#
#========#
#========#
#========#
##########
-Z-
AAAAAAAAAA
C        B
C        B
C        B
C        B
C        B
C        B
C        B
C        B
rrrrrrrrrr
-Z-
AAAAAAAAAA
C        B
C     BBBB
C     BBBB
C     BBBB
C        B
C        B
C        B
C        B
rrrrrrrrrr
-Z-
AAAAAAAAAA
C        B
C  X     B
C        B
C        B
C        B
C        B
C rrrrr  B
C rrrrr  B
rrrrrrrrrr
