{"origin": [1,1,5]}
-LEVEL-
##########
##########
##########
##########
##########
##########
##########
##########
##########
##########
##########
##########
##########
-Z-
##########
##########
##########
#LLLLLLLL#
#LLLLLLLL#
#LLLLLLLL#
#LLLLLLLL#
#LLLLLLLL#
#LLLLLLLL#
##########
##########
##########
##########
-Z-
##########
##########
##########
#        #
#        #
#        #
#        #
#        #
#        #
##########
##########
##########
##########
-Z-
##########
##########
##########
#        #
#        #
#        #
#        #
#        #
#        #
##########
##########
##########
##########
-Z-
##########
#        #
#        #
#        #
#        #
#        #
#        #
#        #
#        #
#        #
#        #
#        #
##########
-Z-
##########
#        #
#        #
#        #
#        #
#        #
#        #
#        #
#        #
#        #
#        #
#X       #
##########
-Z-
##########
##########
##########
##########
##########
##########
##########
##########
##########
##########
##########
##########
##########
-Z-
