{"origin": [7.885138988494873, 8.8643894195556641, 2.0837018489837646], "next_level": null, "pointlights": []}
-LEVEL-
              
              
              
LLLLLLLLLL    
LLLLLLLLLL    
LLLLLLLLLL    
LLLLLLLLLL    
LLLLLLLLLL    
LLLLLLLLLL    
LLLLLLLLLL    
LLLLLLLLLL    
LLLLLLLLLL    
LLLLLLLLLL    
LLLLLLLLLL    
-Z-
              
              
              
AAAAAAAAAA    
AAAAAAAAAA    
AAAAAAAAAA    
AAAAAAAAAA    
AAAAAAAAAA    
AAAAAAAAAA    
AAAAAAAAAA    
AAAAAAAAAA    
AAAAAAAAAA    
AAAAAAAAAA    
AAAAAAAAAA    
-Z-
              
              
              
AAAAAAAAAA    
A        A    
A        A    
A        A    
A        A    
A        A    
A        A    
A        A    
A        A    
A       AA    
AAAAAAAAAA    
-Z-
              
              
              
AAAAAAAAAA    
A        A    
A        A    
A        A    
A        A    
A        A    
A        A    
A        A    
A        A    
A        A    
AAAAAAAAAA    
-Z-
              
              
              
AAAAAAAAAA    
A        A    
A        A    
A        A    
A        A    
A        A    
A        A    
A        A    
A        A    
A        A    
AAAAAAAAAA    
-Z-
              
              
              
AAAAAAAAAA    
A        A    
A        A    
A        A    
A        A    
A        A    
A        A    
A        A    
A        A    
A        A    
AAAAAAAAAA    
-Z-
              
              
              
AAAAAAAAAA    
A        A    
A        A    
A        A    
A        A    
A        A    
A        A    
A        A    
A        A    
A        A    
AAAAAAAAAA    
-Z-
         AAAAA
A        AAAAA
A        AAAAA
AAAAAAAAAAAAAA
A        A    
A        A    
A        A    
A        A    
A        A    
A        A    
A        A    
A        A    
A        A    
AAAAAAAAAA    
-Z-
             X
A             
              
              
              
              
              
              
              
              
              
              
              
              
