{"origin": [6.6806621551513672, 5.0675501823425293, 20.84571647644043], "next_level": null, "pointlights": [[3.2446277141571045, -2.4056005477905273, 6.2372608184814453], [5.4225964546203613, 6.8763494491577148, 11.816904067993164], [7.390047550201416, 4.6506805419921875, 19.762889862060547]]}
-LEVEL-
    ======    
    ===LL=    
  ==========  
  ==========  
==============
==============
==============
==============
==============
==============
  ==========  
  ==========  
    ======    
    ======    
-Z-
    ======    
    =X=  =    
  ==========  
  =    =====  
===        ===
=            =
=            =
=            =
=            =
===        ===
  =        =  
  ===    ===  
    =    =    
    ======    
-Z-
    ======    
    = =  =    
  =====  ===  
  =    =====  
===        ===
=            =
=            =
=            =
=            =
===        ===
  =        =  
  ===    ===  
    =    =    
    ======    
-Z-
    ======    
    = =  =    
  =====  ===  
  =    =====  
===        ===
=            =
=            =
=            =
=            =
===        ===
  =        =  
  ===    ===  
    =    =    
    ======    
-Z-
    ======    
    = =  =    
  === =  ===  
  =====  ===  
==============
==============
==============
==============
==============
==============
  ==========  
  ==========  
    ======    
    ======    
-Z-
    ======    
    = =  =    
  === =  ===  
  = = =    =  
=== ===    ===
=   ===      =
=            =
=            =
=            =
===        ===
  =        =  
  ===    ===  
    =    =    
    ======    
-Z-
    ======    
    = =  =    
  === =  ===  
  = = =    =  
=== = =    ===
=   ===      =
=            =
=            =
=            =
===        ===
  =        =  
  ===    ===  
    =    =    
    ======    
-Z-
    ======    
    ===  =    
  ==========  
  ==========  
===== ========
==============
==============
==============
==============
===  =========
  =  =======  
  ==========  
    ======    
    ======    
-Z-
    ======    
    = =  =    
  === =  ===  
  =   =    =  
===   =    ===
=     =      =
=     =      =
=     =      =
=     =      =
===   =    ===
  =   =    =  
  === =  ===  
    = =  =    
    ======    
-Z-
    ======    
    = =  =    
  === =  ===  
  =   =    =  
===   =    ===
=     =      =
=     =      =
=     =      =
=     =      =
===   =    ===
  =   =    =  
  === =  ===  
    = =  =    
    ======    
-Z-
    ======    
    ======    
  ==========  
  ======== =  
==============
==============
==============
==============
==============
==============
  ==========  
  ==========  
    ======    
    ======    
-Z-
    ======    
    =    =    
  ===    ===  
  =      = =  
===      = ===
=        =   =
=        =   =
=        =   =
=        =   =
===      = ===
  =      = =  
  ===    ===  
    =    =    
    ======    
-Z-
    ======    
    =    =    
  ===    ===  
  =      = =  
===      = ===
=        =   =
=        =   =
=        =   =
=        =   =
===      = ===
  =      = =  
  ===    ===  
    =    =    
    ======    
-Z-
    ======    
    ======    
  ==========  
  ==========  
==============
= ============
= ========== =
= ========== =
= ============
==============
  ==========  
  =====  ===  
    ===  =    
    ======    
-Z-
    ======    
    =    =    
  ===    ===  
  =        =  
===        ===
= =          =
= =          =
= =          =
= =          =
===        ===
  =        =  
  ===    ===  
    =    =    
    ======    
-Z-
    ======    
    =    =    
  ===    ===  
  =        =  
===        ===
= =          =
= =          =
= =          =
= =          =
===        ===
  =        =  
  ===    ===  
    =    =    
    ======    
-Z-
    ======    
    ======    
  ==========  
  ==========  
==============
==============
= ============
= ============
==============
==============
  ==========  
  ==========  
    ======    
    ======    
-Z-
    ======    
    =    =    
  ===    ===  
  =        =  
===        ===
=            =
=            =
=            =
=            =
===        ===
  =        =  
  ===    ===  
    =    =    
    ======    
-Z-
    ======    
    =    =    
  ===    ===  
  =        =  
===        ===
=            =
=            =
=            =
=            =
===        ===
  =        =  
  ===    ===  
    =    =    
    ======    
-Z-
    ======    
    =    =    
  ===    ===  
  =        =  
===        ===
=            =
=            =
=            =
=            =
===        ===
  =        =  
  ===    ===  
    =    =    
    ======    
