{"origin": [1,1,3], "next_level": "level1",
"pointlights" : [[1,1,3],[8,8,3]]}
-LEVEL-
##################
#================#
#================#
#================#
#================#
#================#
#================#
#================#
#================#
#================#
#================#
#================#
#================#
#================#
##################
-Z-
##################
#                #
#                #
#                #
#                #
#                #
#                #
#                #
#                #
#                #
#                #
#                #
#                #
#                #
##################
-Z-
##################
#                #
#                #
#                #
#                #
#                #
#                #
#                #
#                #
#                #
#                #
#                #
#                #
#                #
##################
-Z-
##################
#                #
#                #
#                #
#                #
#                #
#                #
#                #
#                #
#                #
#                #
#                #
#                #
#                #
##################
-Z-
##################
#                #
#                #
#                #
#                #
#                #
#                #
#                #
#                #
#                #
#                #
#                #
#                #
#                #
##################
-Z-
##################
#                #
#                #
#                #
#                #
#                #
#                #
#                #
#                #
#                #
#                #
#                #
#                #
#             2  #
##################
-Z-
##################
#                #
#                #
#                #
#                #
#                #
#                #
#                #
#                #
#                #
#                #
#                #
#                #
#                #
##################
-Z-
##################
#                #
#                #
#                #
#                #
#                #
#                #
#     1          #
#                #
#                #
#                #
#                #
#                #
#                #
##################
-Z-
##################
#                #
#                #
#                #
#                #
#                #
#                #
#                #
#                #
#                #
#                #
#                #
#                #
#                #
##################
